++++++++++++++++++++++++++++++++++++++++++++++++++++++++++++++++++
+                                                                +
+A ++++++++++++++++++++++++++++++++++++++++++++++++++++++++++++  +
+B        1                     +c+                              +
+C                              +b+                              +
+D                              +d+                              +
+E                                                               +
+++  0                                                           +
+e+                                                              +
+a+                                                              +
+ +                                                              +
+ +                                                              +
+ ++++++++++++++++++++++++++++++++++++++++++++++++++++++++++++++ +
+                                                                +
++++++++++++++++++++++++++++++++++++++++++++++++++++++++++++++++++
