red: 0,R
cyan: 1,D
orange: 2,A
+++++++++++++++++++++++++++
+++++++++++ +  +++++ ++++++
++++++ ++         ++d++++++
++++++ ++ +++ +++ ++ ++++++
++++++ ++ +     + ++ ++++++
+r   a    +     +         +
++++++ ++ + 012 + ++ ++++++
++++++ ++ +++++++ ++ ++++++
++++++ ++  RDA    ++ ++++++
+++++++++++++++++++++++++++