red: 0,A
green: 1,B
++++++++++++++++++++++++++++
+          0 +         Aa  +
+     1      +         Bb  +
+ +++++++++++++++++        +
+                          +
++++++++++++++++++++++++++++
