red: 0,A
green: 1,B 
++++++++++++
+     0 B+a+
+ ++++++++A+
+          +
+ ++++++++ +
+b+1       +
++++++++++++
