+++++++++
+    0  +
+   + + +
+A  + + +
+   + +a+
+   + +b+
+C+B+ +c+
+++++++++
