+++++++++
+    0  +
+   + + +
+   + + +
+   + +c+
+   + +b+
+A+C+B+a+
+++++++++
