blue: 0,A,F
cyan: 1,2,H,I
++++++++++++++++++++++++
+  a              A    +
+                      +
+                      +
+        2             +
+  i    I         0    +
+  h       H           +
+  f     1         F   +
++++++++++++++++++++++++