blue: 0,3,A,F
cyan: 1,2,H,I
++++++++++++++++++++++++
+  a              A   2+
+                      +
+         03           +
+                      +
+  i    I              +
+  h     1 H           +
+  f               F   +
++++++++++++++++++++++++