blue: 4,0,5,6,A,E,J,K,L,F
red: 1,B
yellow: 2,C
magenta: 3,7,D,G
cyan: 8,9,H,I
++++++++++++++++++++++++
+ a G 1          7 A g +
+ b H 2          8 B h +
+ c I 3          9 C i +
+                      + 
+ d J 4          0 D j +
+ e K 5            E k +
+ f L 6            F l +
++++++++++++++++++++++++
